..-----N-----
..|         |
..|   ~~~~~~|
---   ~     |
W     ~     |
---   ~~~~  |
..|         |
..-----S-----