------------
|          |
W   |      |
|   |      |
------     E
.....-------