------------
|          |
|    ~~    |
W  ~~~~~~  E
|    ~~    |
------------