---------
|       E
|    |---
|    |------
|    |     |
|          |
|    |     |
--------S---