..-----N----
..|        |
..|   ~~~~~|
---~~      |
|    ~~    |
---  ~~~~  |
..|        |
..-----S----