---N----
|      |
|      |
|      E
|~~~   |
W      |
|      |
---S----