-----N----
|        |
|        |
|   |~~~~|
W   ------
|   |~~~~|
|   ~    E
|        |
----------