---------N----
|            |
|---------|  |
|~           |
|~     |-----|
|~           |
---S----------