........|-N--
........|   |
........|   |
........|   |
--------|   |
W           |
-------------