......--N--
......|   |
......|   |
......|   |
------|   |
W         |
------|   |
......|   |
......|   |
......|   |
......--S--